PPPPPPPPPPPPPPPPPPPPPPPPPPPPPPPPPPPPPPPPPPPPPPPPPPP
P                                                 P
P     P                                           P
P                                                 P
P   E                                             P
P                                                 P
P                                                 P
P                     PPP                         P
P                                                 P
P                                                 P
P                                                 P
P                                                 P
P                                                 P
P                                                 P
P                                                 P
P                  PPP                            P
P                                                 P
P                                                 P
P                                                 P
P                               PPP               P
P                                                 P
P                                                 P
P       PPP                                       P
P                                                 P
PPPPPPPPPPPPPPPPPPPPPPPPPPPPPPPPPPPPPPPPPPPPPPPPPPP